##############################
##############################
##############################
##############################
##############################
##############################
##############################
#########------------#########
#########|####@@####|#########
#########|#@@@@@@@@#|#########
#########|##@@x@@@##|#########
#########|#####@####|#########
#########|####@@####|#########
#########|####@#####|#########
#########|###@@#####|#########
#########|###@@#####|#########
#########|####@#####|#########
#########|####@@####|#########
#########|####x@####|#########
#########|#####@####|#########
#########|#####@####|#########
#########|####@@####|#########
#########------------#########
##############################
##############################
##############################
##############################
##############################
##############################
##############################