#@@@@@@#@@@@@@@@@@@###@@@@@#@@
##@@@@###@@#@@@@@@@@#@@@@@###@
#@@@@@@#@@###@@@@@@@@@@@@@@#@@
@@@@@@@@@@@#@@@@@@@@#@@@@@@@@@
@@@@@@@@@@@#@@@@@@@####@@@@@@#
@@@@@#@@@@###@@@@@@@####@@@@##
@@@@###@@@@#@@@@@@@@@@#@@@@@@#
@@@@@#@@@@@@@@@@@@@@@@@@@@#@@@
@@@@@#@@@@@#@@@@@@@@@@@@@###@@
@@@@###@@@###@@@#@@@@@@@@@#@@@
--@@@#@@#@@#@@@###@@@@@@@@@@@@
----@@@###@@@@@@#@--|?|--@@@@@
@---@@@@#@---------@@@----@@@@
#@---------------@@@@@@@@-----
##@----@@#@@@@@@@@@@@##@@@@@@#
#@@@@#@@###@@#@@@@@####@@@@@##
@@@@###@@#@@###@@@####@@@@@@@#
@@@@@#@@@@@@@#@@@@@#@@@@@@@@@@
#@@@@@@@@@@@@@@@@@@@@@@@@@@@#@
##@@@@@#@@@@@@@@@@@@@#@@@@@###
#@@@@@###@@@@@@@@@@@###@@@@@#@
@@@@@@@#@@@@@@@@@@@@@#@@@@@@@@
@@@@@@@@@@#@@@@@@@@@@@@@@@@@@@
@@@@@@@@@###@@@@@@@@@@@@@@@@@@
@@@@@@@@@@#@@@@@@@@@@@@@@@@@##
###@@@@@@@@@@@@@@@@@@@@@@#####
#######@@@x@@x@@x@@####@######
##########@@@@@@@#############
############__################
############@@################