@###@@@@@@@@@@###@@@@@@@@@@@##
@@#@@@@@@@@#@@@#@@@@@@@@@@@@@#
@@@@@@@@@@###@@@@@@@@@@@@@@@@@
#@@@@@@@@@@#@@@@@@@@#@@@@@@@@@
##@@@@@@@#@@@#@@@@@####@@@@@@#
#@@@@#@@###@###@@@@@####@@@@##
@@@@###@@#@@@#@@@@@@@@#@@@@@@#
@@@@@#@@@@@@@@@@@@@@@@@@@@@@@@
@#@@@@@@@@@@#@@@#@@@@@@@@@@@@@
###@@@@@@@@###@####@@@@#@@@@@@
@#@@@@@@@@@@#@######@@###@#@@#
@@@@@#@@@@@#@@@#@@#@@@@#@###@@
@@@@###@@@###@@@#@@@x@@@@@#@@@
@x@@@#@@#@@#@@@###@@@@@@#@@@@@
@@@@#@@###@@@@@@#@@#@@@###@@@#
#@@###@@#@@@@@#@@@###@@@#@@@##
@@@@#@@@@@@@@###@@@#@@@@@@@@@#
@@@@@@@@@@@@@@#@@@@@@@@@@@@@@@
#@@@@@@@@@@@@@@@@@@@@@@@@@@@#@
##@@@@@#@@@@@@@@@@@@@#@@@@@###
#@@@@@###@@@@@@@@@@@###@@@@@#@
@@@@@@@#@@@@@@@@@@@@@#@@@@@@@@
@@@@@@@@@@#@@@@@@@@@@@@@@@@@@@
@@#@@@@@@###@@@@@@@@@@#@@@@@@#
@###@@@@#@#@@@@@#@@@@###@@@@#@
@@#@@@@###@#@@@###@@@@#@@#@###
@@@@@@@@#@###@@@#@@#@@@@###@#@
@@@@@@@@@@@#@@@@@@###@@@@#@@@@
#@@@@@@#@@@@@@@x@@@#@@@@@@@#@@
##@@@@###@@#@@@@@@@@#@@@@@###@